######################DD######################DDDD#############################DDD##########################################
######################DD######################DDDD#############################DDD##########################################
######################DD######################DDDD#############################DDD##########################################
######################DD######################DDDD#############################DDD##########################################
######################DD######################DDDD#############################DDD##########################################
######################DD######################DDDD#############################DDD##########################################
######################DD######################DDDD#############################DDD##########################################
######################DD######################DDDD#############################DDD##########################################
######################DD######################DDDD#############################DDD##########################################
######################DD######################DDDD#############################DDD##########################################
#################DDDDDDD#####################DDDD#############################DDD###DD######################################
#################DDDDDDD#####################DDDD#############################DDD##DDD######################################
#################DD##########################DDDD#############################DDDDDDD#######################################
##############DDDDD##########################DDDD#############################DDDDDD########################################
##############DDDDD##########################DDDD#############################DDD###########################################
##############DDD############################DDDD#############################DDD###########################################
##############DDD############################DDDD#############################DDD###########################################
##############DDD############################DDDD#############################DDD###########################################
kKkKkKkKkKkKkKDDDKkKkKkKkKkKkKkKkKkKkKkKkKkKkDDDDKkKkKkKkKkKkKkKkKkKkKkKkKkKkKDDDKkKkKkKkKkKkKkKkKkKkKkKkKkKkKkKkKkKkKkKkKkK
gggggggggggggggggggggggggggggggggggggggggggggggggggggggggggggggggggggggggggggggggggggggggggggggggggggggggggggggggggggggggggg