=--------#######################---------##################=
=##########################################################=
###########################################################=
###########################################################=
=;;;;;;;;;;;;;;;;===----====----====----====----==========;=
=####------######=;;----=;#################################=
=####;;;;;;######=;;;;;;=;#######====####========;========;=
=########====####========;#######====####========;========;=
=----------------------------------------------------------=
=------;;;-------===;;;;==================================;=
=;;;;;;=;;;;;;=;;;;;;;;;=========;=;;;;;;=;;;;;;;;;;;;;;;;;=
=;#;;;;;;#;;;;;;;===;;;;=;;;;;;;;;=;;;;;;=;;;;;;;;;;;;;;;;;=
=;#;;;;;;#;;;;;;;=;;;;;;=;;;;;;;;;=;;;;;;=;;;;;;;;;;;;;;;;;=
=;#;;;;;;#;;;;;;;=;;;;;;=;;;;;;;;=;;;;;;=;;;;;;;;=;;;;;;;;;=
=;#;;;;;;#;;;;;;;=;;;;;;=;;;;;;;;=;;;;;;=;;;;;;;;=;;;;;;;;;=
=;#;;;;;;#;;;;;;;=;;;;;;=;;;;;;;;====;;;;========;;;;;;;;;;=
=;#;;;;;;#;;;;;;;=;;;;;;=;=;#;;;;;;#;;;;;;;=;;;;;;=;=;#;;;;=
=;;;;;;;;;;;;;;;;;;;;;;;=;#######====####========;========;=
=======================;;;================================;=
=========================;;;==============================;=
=;;;;;;;;;;;;;;;;=------==;;;;;;;;;;;;;;;;=------=========;=
=;;;;;;;;;;;;;;;;=------==;;;;;;;;;;;;;;;;=------=========;=
=;;;;;;;;;;;;;;;;=------==;;;;;;;;;;;;;;;;=------=========;=
;;;;;;;;;=;;;;;;=;;;;;;;;;;=;;;;;;=;;;;;;;;;;=;;;;---------=
============================================================
=;;;;;;;;;;;;;;;;;;;;;;;=;#######====####========;========;=
=======================;;;================================;=
=========================;;;==============================;=
=;;;;;;;;;;;;;;;;=------==;;;;;;;;;;;;;;;;=------=========;=
=;;;;;;;;;;;;;;;;=------==;;;;;;;;;;;;;;;;=------=========;=
=;;;;;;;;;;;;;;;;=------==;;;;;;;;;;;;;;;;=------=========;=
;;;;;;;;;=;;;;;;=;;;;;;;;;;=;;;;;;=;;;;;;;;;;=;;;;---------=
============================================================
=;;;;;;;;;;;;;;;;;;;;;;;=;#######====####========;========;=
=======================;;;================================;=
=========================;;;==============================;=
=;;;;;;;;;;;;;;;;=------==;;;;;;;;;;;;;;;;=------=========;=
=;;;;;;;;;;;;;;;;=------==;;;;;;;;;;;;;;;;=------=========;=
=;;;;;;;;;;;;;;;;=------==;;;;;;;;;;;;;;;;=------=========;=
;;;;;;;;;=;;;;;;=;;;;;;;;;;=;;;;;;=;;;;;;;;;;=;;;;---------=
============================================================