=#######====#####=;;;;;;=;
=#########.######=;;;;;;=;
=#.#--##-###---##=;;;;;;=;
=;#;;;;####;;##;;========;
=;;;;;;;;;;;;;;;;===----=;
=####------######=;;----=;
=####;;;;;;######=;;;;;;=;
=########====####========;
=;;;;;;;;;;;;;;;;=------=;
=------;;;-------===;;;;=;
=;;;;;;=;;;;;;=;;;;;;;;;=;
=;#;;;;;;#;;;;;;;===;;;;=;
=;#;;;;;;#;;;;;;;=;;;;;;=;
=;#;;;;;;#;;;;;;;=;;;;;;=;
=;#;;;;;;#;;;;;;;=;;;;;;=;
=;#;;;;;;#;;;;;;;=;;;;;;=;
=;#;;;;;;#;;;;;;;=;;;;;;=;
=;;;;;;;;;;;;;;;;;;;;;;;=;
=========================;
=========================;