#######====#####=
#########.######=
#.#--##-###---##=
;#;;;;####;;##;;=
;;;;;;;;;;;;;;;;=
####------######=
########====####=
;;;;;;;;;;;;;;;;=
------;;;-------=
;#;;;;;;#;;;;;;;=