============================================================
============================================================
#;;;;;;;;;;;;;;;;;;;;;;;;;;=;;;;;=;;;;;;;;;;;;;;;;;;;;;;;;;=
#;;;;;;;;;;;;;;;;;;;;;;;;;;=;;;;;=;;;;;;;;;;;;;;;;;;;;;;;;;=
=;;;;;;;;;;;=========;;;;;;=;;;;;=;;;;;;;;=;;;;;;;;;;;;;;;;=
=;;;========;;;;;;;;;;;;;;;=;;;;;=;;;;;;;;=;;;;;;;;;;;;;;;;=
=;;;;;;;;;;;;;;;;;;;;;======;;;;;=;;;;;;;;=;;;;;;;;;;;;;;;;=
=;;;;;;;;;;;;;;;;;;;;;;;;;;=;;;;;=;;;;;;;;=;;;;;;;;;;;;;;;;=
=;;;;;;;;;;;;;;;;;;;;;;;;;;=========================;;;;;;;=
=;;;;;;;;;=============;;;;=;;;;;;;;;;;;;;=;;;;;;;;;;;;;;;;=
=;;;;;;;;;;;;;=;;;;;;;;;;;;=;;;;;;;;;;;;;;=;;;;;;;;;;;;;;;;=
=;;;;;;;;;;;;;=;;;;;;;;;;;;=;;;;;;;;;;;;;;=;;;;;;;;;;;;;;;;=
=;;;;;;;;;;;;;=;;;;;;;;;;;;=;;;;;;;;;;;;;;=;;;;;;;;;;;;;;;;=
=;;;;;;;;;;;;;=;;;;;;;;;;;;=;;;;;;;;;;;;;;;;;;;;;;;;;;;;;;;=
=;;;;;;;;;;;;;========;;;;;=;;;;;;;;;;;;;;;;;;;;;;;;;;;;;;;=
=;;;;;;;;;;;;;;;;;;;;;;;;;;=;;;;;;;;;;;;;;;;;;;;;;;;;;;;;;;=
=;;;;;;;;;;;;;;;;;;;;;;;;;;=;;;;;;;;;;;;;;;;;;;;;;;;;;;;;;;=
=;;;;;;;;;;;;;;;;;;;;;;;;;;;;;;;;;;;;;;========;;;;;;;;;;;;=
=;;;;;;;;;;;;;;;;;;;;;;;;;;;;;;;;;;;;;;;;;;;;;;;;;;;;;;;;;;=
=;;;;;;;;;;;;;;===========================;;;;;;;;;;;;;;;;;=
=;;;;;;;;;;;;;;;;;;;;;;;;;;;;;;;;;;;;;;;;;;;;;;;;;;;;;;;;;;=
=;;;;;;;;;;;;;;;;;;;;;;;;;;;;;;;;;;;;;;;;;;;;;;;;;;;;;;;;;;=
=;;;;;;;;;;;;;;;;;;;;;;;;;;;;;;;;;;;;;;;;;;;;;;;;;;;;;;;;;;=
=;;;;;;;;;;;;;;;;;;;;;;;;;;;;;;;;;;;;;;;;;;;;;;;;;;;;;;;;;;=
=;;;;;;;;;;;;;;;;;;;;;;;;;;;;;;;;;;;;;;;;;;;;;;;;;;;;;;;;;;=
=;;;;;;;;;;;;;;;;;;;;;;;;;;;;;;;;;;;;;;;;;;;;;;;;;;;;;;;;;;=
=;;;;;;;;;;;;;;;;;;;;;;;;;;;;;;;;;;;;;;;;;;;;;;;;;;;;;;;;;;=
=;;;;;;;;;;;;;;;;;;;;;;;;;;;;;;;;;;;;;;;;;;;;;;;;;;;;;;;;;;=
=;;;;;;;;;;;;;;;;;;;;;;;;;;;;;;;;;;;;;;;;;;;;;;;;;;;;;;;;;;=
=;;;;;;;;;;;;;;;;;;;;;;;;;;;;;;;;;;;;;;;;;;;;;;;;;;;;;;;;;;=
=;;;;;;;;;;;;;;;;;;;;;;;;;;;;;;;;;;;;;;;;;;;;;;;;;;;;;;;;;;=
=;;;;;;;;;;;;;;;;;;;;;;;;;;;;;;;;;;;;;;;;;;;;;;;;;;;;;;;;;;=
=;;;;;;;;;;;;;;;;;;;;;;;;;;;;;;;;;;;;;;;;;;;;;;;;;;;;;;;;;;=
=;;;;;;;;;;;;;;;;;;;;;;;;;;;;;;;;;;;;;;;;;;;;;;;;;;;;;;;;;;=
=;;;;;;;;;;;;;;;;;;;;;;;;;;;;;;;;;;;;;;;;;;;;;;;;;;;;;;;;;;=
=;;;;;;;;;;;;;;;;;;;;;;;;;;;;;;;;;;;;;;;;;;;;;;;;;;;;;;;;;;=
=;;;;;;;;;;;;;;;;;;;;;;;;;;;;;;;;;;;;;;;;;;;;;;;;;;;;;;;;;;=
=;;;;;;;;;;;;;;;;;;;;;;;;;;;;;;;;;;;;;;;;;;;;;;;;;;;;;;;;;;=
=;;;;;;;;;;;;;;;;;;;;;;;;;;;;;;;;;;;;;;;;;;;;;;;;;;;;;;;;;;=
=;;;;;;;;;;;;;;;;;;;;;;;;;;;;;;;;;;;;;;;;;;;;;;;;;;;;;;;;;;=
============================================================